"ID_poste";"ID_instituteur_poste";"Mois_poste";"Annee_poste";"Fonction_poste";"Lieu_poste";"Duree_poste";"Date_fin_poste"
1;1;"octobre";1903;"adjoint";"Andrinople";2;1905
2;1;"octobre";1905;"adjoint";"Sofia";1;1906
3;1;"octobre";1906;"directeur";"Choumla";1;1907
4;1;"octobre";1907;"directeur";"Samacoff";5;1912
5;1;"octobre";1912;"directeur";"Dardanelles";3;1915
6;1;"octobre";1915;"directeur";"Cple-Haskeuy";5;1920
7;1;"janvier";1920;"directeur";"Monastir";3;1923
8;2;"octobre";1877;"adjoint";"Jaffa";1;1878
9;2;"octobre";1878;"adjoint";"Tunis";1;1879
10;2;"octobre";1879;"directeur";"Alep";6;1885
11;2;"octobre";1885;"directeur";"Cple-Haskeuy";3;1888
12;2;"octobre";1888;"directeur";"Bagdad";5;1893
13;2;"juilet";1893;"directeur";"Damas (école religieuse)";1;1894
14;2;"février";1894;"directeur";"Damas";1;1895
15;2;;1895;"directeur";"Le Caire";19;1914
16;3;"octobre";1894;"adjoint";"Alep";2;1896
17;3;"octobre";1896;"adjoint";"Jaffa";1;1897
18;3;"octobre";1897;"adjoint";"Tunis";7;1904
19;3;"janvier";1904;"adjoint";"Tripoli";1;1905
20;3;"janvier";1905;"adjoint";"Fez";2;1907
21;3;"octobre";1907;"adjoint";"Mogador";2;1909
22;3;"mars";1909;"directeur";"Saffi";3;1912
23;3;"janvier";1912;"directeur";"Hanekine";1;1913
24;3;"octobre";1913;"directeur";"Chiraz";8;1921
25;4;"octobre";1894;"adjoint";"Jaffa";1;1895
26;4;"octobre";1895;"adjoint";"Alep";3;1898
27;4;"octobre";1898;"adjoint";"Mikweh-Israël";3;1901
28;4;"octobre";1901;"directeur";"Tibériade";4;1905
29;4;"octobre";1905;"directeur";"Alep";3;1908
30;4;"octobre";1908;"directeur";"Aïdin";4;1912
31;4;"octobre";1912;"directeur";"Gallipoli";3;1915
32;4;"octobre";1915;"directeur";"Brousse";6;1921
33;4;"octobre";1921;"directeur";"Janina";10;1931
34;5;;1899;"adjoint";"Tanger";3;1902
35;5;;1902;"adjoint";"Tunis";5;1907
36;5;;1907;"directeur";"Sousse";19;1926
37;6;"octobre";1925;"adjointe";"Beyrouth";1;1926
38;7;;1897;"adjointe";"Salonique";1;1898
39;7;;1898;"directrice";"Cple-Conscundjouk";2;1900
40;7;;1900;"directrice";"Smyrne";1;1901
41;8;"octobre";1931;"adjointe";"Marrakech";4;1935
42;8;;1935;"adjointe";"Tanger";4;1939
43;9;;1900;"adjoint";"Tunis";5;1905
44;9;;1905;"adjoint";"Le Caire";1;1906
45;9;"octobre";1906;"adjoint";"Cple-Balata";1;1907
46;9;"octobre";1907;"directeur";"Tatar-Bazardjik";2;1909
47;9;"avril";1909;"directeur";"Mogador";6;1915
48;9;"octobre";1915;"directeur";"Tétuan";5;1920
49;9;"octobre";1920;"directeur";"Tripoli";7;1927
50;9;"octobre";1927;"directeur";"Sousse";6;1933
51;9;"octobre";1933;"directeur";"Tunis";2;1935
52;10;"septembre";1892;"adjoint";"Smyrne";2;1894
53;10;"octobre";1894;"surveillant";"Jérusalem";1;1895
54;10;"octobre";1895;"adjoint";"Damas";3;1898
55;10;"octobre";1898;"adjoint";"Beyrouth";1;1899
56;10;"octobre";1899;"directeur";"Magnésie";1;1900
57;10;"octobre";1900;"adjoint";"Beyrouth";1;1901
58;10;"octobre";1901;"directeur";"Jaffa";7;1908
59;10;"mai";1908;"directeur";"Hôpital Jérusalem";11;1919
60;11;"décembre";1917;"adjointe";"Fez";4;1921
61;11;"octobre";1921;"adjointe";"Cple";3;1924
62;11;"octobre";1924;"directrice";"Cple-Ortakeuy";2;1926
63;11;"octobre";1926;"adjointe";"Smyrne";;
64;12;"octobre";1931;"adjoint";"Marrakech";3;1934
65;12;"octobre";1934;"directeur";"Demnat";3;1937
66;12;"octobre";1937;"adjoint";"Casablanca";8;1945
67;13;"octobre";1905;"adjoint";"Damas";4;1909
68;13;"octobre";1909;"directeur";"Rhodes";2;1911
69;14;"octobre";1929;"adjoint";"Mogador";3;1932
70;14;"octobre";1932;"adjoint";"Téhéran";1;1933
71;15;"octobre";1910;"adjointe";"Tanger";4;1914
72;16;"octobre";1926;"adjointe";"Marrakech";1;1927
73;16;"octobre";1927;"adjointe";"Tanger";2;1929
74;17;"octobre";1924;"adjointe";"Casablanca";5;1929
75;18;"octobre";1910;"adjointe";"Andrinople";2;1912
76;18;"octobre";1912;"adjointe";"Aïdin";1;1913
77;18;"octobre";1913;"directrice";"Aïdin";6;1919
78;18;"octobre";1919;"directrice";"Mazagan";5;1924
79;18;"janvier";1924;"adjointe";"Tanger";0;1924
80;18;"octobre";1924;"directrice";"Meknès";1;1925
81;18;"octobre";1925;"adjointe";"Tanger";1;1926
82;18;"octobre";1926;"directrice";"Tanger";1;1927
83;18;"octobre";1927;"adjointe";"Casablanca";2;1929
84;19;"octobre";1930;"adjointe";"Mazagan";3;1933
85;19;"octobre";1933;"adjointe";"Ber-Rechid";2;1935
86;19;"octobre";1935;"adjointe";"Casablanca";4;1939
87;19;"octobre";1939;"adjointe";"Damas";;
88;20;"octobre";1930;"adjoint";"Fez";;
89;21;;1900;"adjoint";"Smyrne";2;1902
90;21;;1902;"adjoint";"Tunis";3;1905
91;22;"octobre";1917;"adjoint";"Mazagan";1;1918
92;23;"octobre";1931;"adjointe";"Safi";1;1932
93;23;"octobre";1932;"adjointe";"Fez";1;1933
94;24;"octobre";1911;"adjoint";"Bagdad";1;1912
95;25;"novembre";1884;"adjoint";"Damas";5;1889
96;25;"novembre";1889;"directeur";"Damas";2;1891
97;25;"octobre";1891;"directeur";"Beyrouth";4;1895
98;25;"octobre";1895;"directeur";"Philippopolis";10;1905
99;25;"octobre";1905;"Envoyé en";"Argentine";;
100;26;"octobre";1928;"adjoint";"Mogador";2;1930
101;26;"octobre";1930;"adjoint";"Beni-Mellal";4;1934
102;26;"octobre";1934;"adjoint";"Casablanca";5;1939
103;27;"septembre";1907;"adjointe";"Beyrouth";1;1908
104;27;"octobre";1908;"adjointe";"Dardanelles";3;1911
105;28;"octobre";1916;"adjoint";"Rhodes";3;1919
106;29;"octobre";1926;"adjoint";"Safi";1;1927
107;30;"octobre";1905;"adjointe";"Salonique";1;1906
108;30;"octobre";1906;"adjointe";"Smyrne";4;1910
109;30;"octobre";1910;"adjointe";"Cple-Balata";2;1912
110;30;"octobre";1912;"adjointe";"Cple-Haskeuy";14;1926
111;31;"octobre";1906;"adjoint";"Alexandrie";1;1907
112;32;"novembre";1884;"adjoint";"Sofia";2;1886
113;32;"mars";1886;"adjoint";"Tunis";2;1888
114;32;"octobre";1888;"directeur";"Sousse";5;1893
115;32;"octobre";1893;"directeur";"Bagdad";7;1900
116;32;"octobre";1900;"directeur";"Alexandrie";20;1920
117;32;"octobre";1920;"directeur";"Beyrouth";3;1923
118;33;"octobre";1894;"adjoint";"Dardanelles";2;1896
119;33;"octobre";1896;"adjoint";"Cple-Balata";1;1897
120;33;"octobre";1897;"adjoint";"Alexandrie";2;1899
121;33;"octobre";1899;"adjoint";"Le Caire";5;1904
122;34;"octobre";1900;"adjointe";"Andrinople";2;1902
123;34;"janvier";1902;"adjointe";"Meknès";0;1902
124;34;"novembre";1902;"adjointe";"Fez";3;1905
125;34;"novembre";1905;"directrice";"Bagdad";;
126;35;"janvier";1927;"adjointe";"Jérusalem";3;1930
127;35;"octobre";1930;"adjointe";"Caïffa";;
128;36;"septembre";1892;"adjointe";"Tanger";2;1894
129;36;"octobre";1894;"adjointe";"Tatar-Bazardjik";4;1898
130;36;"octobre";1898;"adjointe";"Damas";1;1899
131;36;"octobre";1899;"adjointe";"Bagdad";5;1904
132;36;"octobre";1904;"directrice";"Philippopolis";1;1905
133;36;"octobre";1905;"directrice";"Beyrouth";7;1912
134;36;"octobre";1912;"directrice";"Tanger";17;1929
135;37;"octobre";1922;"adjoint";"Tripoli";1;1923
136;38;"octobre";1894;"adjoint";"Beyrouth";1;1895
137;38;"octobre";1895;"adjoint";"Philippopolis";2;1897
138;38;"octobre";1897;"adjoint";"Salonique";2;1899
139;38;"octobre";1899;"adjoint";"Smyrne";1;1900
140;38;"octobre";1900;"adjoint";"Argentine";;
141;39;"octobre";1916;"adjoint";"Sfax";0;1916
142;40;"octobre";1936;"adjointe";"Ispahan";2;1938
143;40;"octobre";1938;"adjointe";"Damas";;
144;41;"octobre";1923;"adjointe";"Mogador";5;1928
145;41;"octobre";1928;"adjointe";"Mazagan";11;1939
146;41;"octobre";1939;"adjointe";"Casablanca";;
147;42;"octobre";1929;"adjoint";"Damas";0;1929
148;43;"octobre";1934;"adjointe";"Meknès";;
149;44;"octobre";1916;"adjoint";"Salonique";3;1919
150;45;"octobre";1931;"adjoint";"Salé";2;1933
151;45;"octobre";1933;"adjoint";"Mogador";2;1935
152;45;"octobre";1935;"adjoint";"Mazagan";;
153;46;"octobre";1929;"adjointe";"Larache";2;1931
154;46;"octobre";1931;"adjointe";"Casablanca";1;1932
155;46;"octobre";1932;"adjointe";"Fez";2;1934
156;46;"octobre";1934;"adjointe";"Salé";1;1935
157;46;"octobre";1935;"adjointe";"Damas";1;1936
158;46;"octobre";1936;"adjointe";"Safed";3;1939
159;46;"octobre";1939;"adjointe";"Caïffa";;
160;47;;1898;"adjointe";"Andrinople";3;1901
161;47;;1901;"directrice";"Ispahan";4;1905
162;47;;1905;"directrice";"Cple-Balata";14;1919
163;49;"octobre";1933;"adjointe";"Fez";;
164;50;"octobre";1911;"adjointe";"Bagdad";10;1921
165;50;"octobre";1921;"adjointe";"Caïffa";;
166;51;"octobre";1928;"adjoint";"Tanger";;
167;52;"octobre";1912;"adjoint";"Damas";7;1919
168;53;"octobre";1917;"adjointe";"Alexandrie";4;1921
169;53;"octobre";1921;"adjointe";"Damas";3;1924
170;53;"octobre";1924;"adjointe";"Bagdad";5;1929
171;53;"octobre";1929;"directrice";"Kimanchah";5;1934
172;53;"octobre";1934;"directrice";"Mossoul";;
173;54;"octobre";1925;"adjoint";"Tanger";3;1928
174;54;"octobre";1928;"adjoint";"Saffi";1;1929
175;55;"octobre";1904;"adjoint";"Salonique";1;1905
176;55;"octobre";1905;"adjoint";"Le Caire";7;1912
177;56;"octobre";1938;"adjointe";"Damas";1;1939
178;57;"octobre";1924;"adjoint";"Fez";1;1925
179;58;"octobre";1932;"adjointe";"Meknès";1;1933
180;58;"octobre";1933;"adjointe";"Tanger";2;1935
181;58;"octobre";1935;"adjointe";"Mazagan";4;1939
182;59;"avril";1909;"adjointe";"Bagdad";2;1911
183;59;"octobre";1911;"adjointe";"Jérusalem";11;1922
184;59;"octobre";1922;"adjointe";"Jaffa";;
185;60;"octobre";1910;"adjoint";"Bagdad";1;1911
186;60;"octobre";1911;"directeur";"Amara";2;1913
187;60;"octobre";1913;"directeur";"Seneh";6;1919
188;60;"octobre";1919;"directeur";"Brousse";5;1924
189;61;"octobre";1889;"adjointe";"Tunis";2;1891
190;61;"octobre";1891;"adjointe";"Andrinople";2;1893
191;61;"mars";1893;"adjointe";"Sofia";0;1893
192;61;"octobre";1893;"adjointe";"Andrinople";1;1894
193;61;"février";1894;"directrice";"Damas";2;1896
194;61;"octobre";1896;"directrice";"Cple-Ortakeuy";2;1898
195;61;"octobre";1898;"directrice";"Smyrne";7;1905
196;61;"novembre";1905;"directrice";"Le Caire";;
197;62;"septembre";1907;"adjoint";"Le Caire";3;1910
198;62;"octobre";1910;"adjoint";"Tantah";2;1912
199;62;"octobre";1912;"directeur";"Mossoul";8;1920
200;62;"janvier";1920;"directeur";"Tantah";1;1921
201;62;"octobre";1921;"directeur";"Jaffa";2;1923
202;62;"juin";1923;"directeur";"Bagdad";13;1936
203;62;"octobre";1936;"directeur";"Caïffa";3;1939
204;63;"octobre";1936;"adjointe";"Saffi";3;1939
205;64;"octobre";1924;"adjointe";"Mogador";3;1927
206;64;"octobre";1927;"adjointe";"Marrakech";;
207;65;"octobre";1910;"adjointe";"Casablanca";1;1911
208;66;"octobre";1938;"adjoint";"Tanger";1;1939
209;66;"octobre";1939;"adjoint";"Oujda";1;1940
210;67;"octobre";1912;"adjointe";"Caïffa";17;1929
211;68;"septembre";1907;"adjoint";"Kimanshah";3;1910
212;68;"octobre";1910;"adjoint";"Hamadan";1;1911
213;69;"novembre";1896;"adjointe";"Tunis";3;1899
214;69;;1899;"adjointe";"Téhéran";3;1902
215;69;;1902;"adjointe";"Tunis";3;1905
216;69;"mars";1905;"directrice";"Sfax";21;1926
217;69;;1926;"adjointe";"Tunis";7;1933
218;69;;1933;"adjointe";"Tunis";2;1935
219;70;;1898;"adjoint";"Tunis";1;1899
220;70;;1899;"adjoint";"Téhéran";3;1902
221;70;;1902;"adjoint";"Tunis";3;1905
222;70;"mars";1905;"directeur";"Sfax";21;1926
223;70;;1926;"directeur";"Tunis";7;1933
224;71;"octobre";1939;"stagiaire";"Marrakech";1;1940
225;72;"octobre";1933;"adjointe";"Rabat";3;1936
226;72;"octobre";1936;"adjointe";"Casablanca";3;1939
227;73;"octobre";1939;"stagiaire";"Marrakech";1;1940
228;74;"octobre";1934;"adjoint";"Rabat";5;1939
229;75;"octobre";1938;"adjoint";"Hamadan";1;1939
230;76;;1881;"adjoint";"Jaffa";0;1881
231;76;;1881;"adjoint";"Alep";4;1885
232;76;;1885;"adjoint";"Jaffa";1;1886
233;76;;1886;"adjoint";"Alep";3;1889
234;76;;1889;"adjoint";"Tétuan";1;1890
235;77;"octobre";1933;"adjointe";"Mogador";2;1935
236;77;"octobre";1935;"adjointe";"Tripoli";4;1939
237;78;"octobre";1923;"adjoint";"Tripoli";3;1926
238;78;"octobre";1926;"adjoint";"Tripoli";1;1927
239;78;;1927;"directeur";"Tripoli";;
240;79;"octobre";1933;"adjoint";"Tanger";2;1935
241;79;"octobre";1935;"adjoint";"Beyrouth";2;1937
242;81;"septembre";1907;"adjoint";"Tanger";1;1908
243;81;"mars";1908;"professeur";"Argentine";;
244;82;"octobre";1905;"adjoint";"Bagdad";3;1908
245;82;"octobre";1908;"directeur";"Bassorah";3;1911
246;82;"octobre";1911;"directeur";"Hillé";2;1913
247;83;;1897;;"Djédéïa";4;1901
248;83;;1901;"directeur";"Or Yéhouda";8;1909
249;84;"août";1883;"adjointe";"Cple-Balata";3;1886
250;84;"mars";1886;"directrice";"Cple-Ortakeuy";1;1887
251;84;"octobre";1887;"directrice";"Andrinople";3;1890
252;85;"octobre";1904;"adjointe";"Beyrouth";1;1905
253;85;"octobre";1905;"adjointe";"Le Caire";4;1909
254;85;"avril";1909;"adjointe";"Bagdad";2;1911
255;86;;1901;"directrice";"Salonique (asile)";2;1903
256;85;"octobre";1911;"directrice";"Hillé";2;1913
257;86;;1903;"directrice";"Cple-Balata";2;1905
258;87;"octobre";1895;"adjointe";"Andrinople";1;1896
259;87;"octobre";1896;"adjointe";"Philippopolis";5;1901
260;88;"février";1887;"adjointe";"Beyrouth";4;1891
261;88;"octobre";1891;"adjointe";"Damas";3;1894
262;88;"février";1894;"adjointe";"Cple-Balata";2;1896
263;88;"avril";1896;"adjointe";"Cple-Ortakeuy";2;1898
264;88;"octobre";1898;"adjointe";"Beyrouth";8;1906
265;88;"octobre";1906;"adjointe";"Alep";;
266;89;"octobre";1908;"adjoint";"Casablanca";;
267;90;"octobre";1914;"adjointe";"Andrinople";10;1924
268;90;"octobre";1924;"adjointe";"Casablanca";15;1939
269;90;"octobre";1939;"directrice";"Casablanca";1;1940
270;91;"octobre";1896;"adjoint";"Tunis";12;1908
271;91;"octobre";1908;"directeur";"Gallipoli";4;1912
272;91;"octobre";1912;"adjoint";"Tanger";4;1916
273;91;"octobre";1916;"adjoint";"Mogador";3;1919
274;91;"octobre";1919;"directeur";"Mazagan";11;1930
275;91;"octobre";1930;"directeur";"Saïda";2;1932
276;92;"octobre";1911;"adjoint";"Salonique";1;1912
277;92;"octobre";1912;"adjoint";"Andrinople";1;1913
278;92;"octobre";1913;"directeur";"Tétuan";;
279;94;"octobre";1933;"adjoint";"Tunis";;
280;95;"octobre";1929;"adjointe";"Tanger";3;1932
281;95;"octobre";1932;"adjointe";"Sfax";3;1935
282;95;"octobre";1935;"adjointe";"Tunis";2;1937
283;95;"octobre";1937;"adjointe";"Mogador";1;1938
284;96;"octobre";1936;"adjoint";"Hamadan";2;1938
285;96;"octobre";1938;"directeur";"Kimanchah";1;1939
286;97;"octobre";1912;"adjointe";"Jérusalem";17;1929
287;97;"octobre";1929;"adjointe";"Bagdad";3;1932
288;97;"janvier";1932;"adjointe";"Kimanchah";2;1934
289;97;"octobre";1934;"directrice";"Kimanchah";;
290;98;"octobre";1932;"adjointe";"Mogador";2;1934
291;98;"octobre";1934;"adjointe";"Téhéran";5;1939
292;98;"octobre";1939;"adjointe";"Tanger";1;1940
293;99;"octobre";1929;"adjointe";"Safi";2;1931
294;99;"octobre";1931;"adjointe";"Téhéra";1;1932
295;99;"octobre";1932;"directrice";"Yezd";3;1935
296;99;"octobre";1935;"adjointe";"Téhéran";1;1936
297;99;"octobre";1936;"adjointe";"Alep";3;1939
298;100;"octobre";1929;"adjoint";"Meknès";1;1930
299;100;"octobre";1930;"adjoint";"Settat";1;1931
300;100;"octobre";1931;"adjoint";"Téhéran";1;1932
301;100;"octobre";1932;"directeur";"Yezd";3;1935
302;100;"octobre";1935;"adjoint";"Téhéran";3;1938
303;100;"octobre";1938;"adjoint";"Alep";1;1939
304;101;"septembre";1907;"adjoint";"Lyédéïda";2;1909
305;101;"octobre";1909;"surveillant";"Jérusalem";2;1911
306;101;"octobre";1911;"directeur";"Mogador";4;1915
307;101;"janvier";1915;"directeur";"Fez";6;1921
308;101;"octobre";1921;"directeur";"Smyrne";15;1936
309;101;"octobre";1936;"directeur";"Jaffa";3;1939
310;102;"octobre";1905;"adjointe";"Tunis";4;1909
311;102;"octobre";1909;"adjointe";"Jérusalem";2;1911
312;102;"octobre";1911;"directrice";"Mazagan";4;1915
313;102;"janvier";1915;"directrice";"Fez";6;1921
314;102;"octobre";1921;"directrice";"Smyrne";15;1936
315;102;"octobre";1936;"directrice";"Jaffa";3;1939
316;103;"octobre";1911;"adjoint";"Tanger";1;1912
317;103;"octobre";1912;"adjoint";"Tétuan";1;1913
318;104;"mai";1883;"adjointe";"Tanger";;
319;105;"octobre";1898;"adjoint";"Tanger";1;1899
320;105;;1899;"directeur";"Mogador";4;1903
321;105;;1903;"directeur";"Meknès";0;1903
322;105;;1903;"directeur";"Larache";5;1908
323;105;;1908;"directeur";"Uskub";3;1911
324;105;;1911;"directeur";"Monastir";5;1916
325;105;;1916;"directeur";"Casablanca";4;1920
326;106;"octobre";1900;"professeur";"Plessis";1;1901
327;106;;1901;"adjoint";"Tétuan";3;1904
328;106;"janvier";1904;"envoyé en";"Argentine";4;1908
329;107;"décembre";1885;"adjointe";"Damas";2;1887
330;107;"octobre";1887;"adjointe";"Tanger";1;1888
331;107;"novembre";1888;"adjointe";"Tétuan";3;1891
332;107;"octobre";1891;"adjointe";"Tanger";9;1900
333;107;"octobre";1900;"directrice";"Casablanca";8;1908
334;107;"octobre";1908;"adjointe";"Tanger";2;1910
335;108;"octobre";1887;"adjoint";"Smyrne";5;1892
336;108;"septembre";1892;"adjoint";"Andrinople";2;1894
337;108;"septembre";1894;"adjoint";"Salonique";2;1896
338;108;"octobre";1896;"chargé de direction";"Caïffa";2;1898
339;108;"octobre";1898;"directeur";"Jaffa";3;1901
340;108;"octobre";1901;"directeur";"Alep";4;1905
341;108;"octobre";1905;"directeur";"Uskub";3;1908
342;108;"octobre";1908;"directeur";"Monastir";3;1911
343;108;"octobre";1911;"directeur";"Janina";2;1913
344;108;"octobre";1913;"directeur";"Samacot";6;1919
345;109;"février";1879;"adjoint";"Beyrouth";0;1879
346;109;"juillet";1879;"adjoint";"Jaffa";4;1883
347;110;"octobre";1912;"adjoint";"Salonique";4;1916
348;111;"octobre";1901;"adjoint";"Tanger";4;1905
349;111;;1905;"envoyé en";"Argentine";5;1910
350;112;;1897;"adjoint";"Fez";2;1899
351;112;;1899;"adjoint";"Casablanca";1;1900
352;112;;1900;"adjoint";"Tanger";1;1901
353;112;;1901;"directeur";"Larache";2;1903
354;113;"octobre";1928;"adjointe";"Mogador";3;1931
355;113;"octobre";1931;"adjointe";"Marrakech";2;1933
356;113;"octobre";1933;"adjointe";"Tanger";3;1936
357;114;"octobre";1905;"adjointe";"Safed";1;1906
358;114;"octobre";1906;"adjointe";"Caïffa";3;1909
359;114;"octobre";1909;"directrice";"Caïffa";3;1912
360;115;"octobre";1896;"adjoint";"Mikweh-Israël";2;1898
361;115;"octobre";1898;"adjoint";"Djédéïda";3;1901
362;115;"octobre";1901;"adjoint";"Caracache";1;1902
363;115;"octobre";1902;"directeur";"Magnésie";6;1908
364;115;"mai";1908;"directeur";"Ispahan";12;1920
365;116;;1899;"adjointe";"Tunis";2;1901
366;117;"octobre";1935;"adjointe";"Hamadan";4;1939
367;117;"octobre";1939;"adjointe";"Beyrouth";1;1940
368;118;"octobre";1897;"adjoint";"Jérusalem";1;1898
369;118;"mai";1898;"directeur";"Jaffa";13;1911
370;118;"octobre";1911;"directeur";"Smyrne";9;1920
371;119;"octobre";1905;"adjoint";"Ispahan";5;1910
372;119;"octobre";1910;"directeur";"Seneh";4;1914
373;119;"février";1914;"directeur";"Kirklissé";6;1920
374;119;"octobre";1920;"directeur";"Cple";3;1923
375;119;"octobre";1923;"directeur";"Dardanelles";3;1926
376;120;"septembre";1907;"adjoint";"Or-Yehouda";7;1914
377;121;"octobre";1880;"adjoint";"Andrinople";3;1883
378;121;"décembre";1883;"adjoint";"Roustchouk";1;1884
379;121;"juillet";1884;"directeur";"Roustchouk";1;1885
380;121;"août";1885;"adjoint";"Andrinople";2;1887
381;121;"octobre";1887;"directeur";"Tatar-Bazardjik";4;1891
382;121;"octobre";1891;"directeur";"Damas";3;1894
383;121;"février";1894;"adjoint";"Smyrne";1;1895
384;121;"octobre";1895;"directeur";"Choumla";6;1901
385;121;"octobre";1901;"directeur";"Tétuan";3;1904
386;121;"octobre";1904;"directeur";"Janina";4;1908
387;121;"octobre";1908;"directeur";"Philippopolis";1;1909
388;121;"décembre";1909;"directeur";"Beyrouth";1;1910
389;121;"décembre";1910;"directeur";"Jérusalem";1;1911
390;121;"octobre";1911;"directeur";"Serrès";1;1912
391;122;"novembre";1910;"adjointe";"Cple-Balata";2;1912
392;123;"décembre";1917;"adjointe";"Rabat";2;1919
393;124;"août";1874;"directrice";"Salonique";25;1899
394;125;"octobre";1903;"directeur";"Monastir";2;1905
395;125;"octobre";1905;"adjointe";"Brousse";14;1919
396;126;"octobre";1908;"adjoint";"Tanger";3;1911
397;126;"octobre";1911;"directeur";"Azemmour";1;1912
398;127;"mars";1881;"directrice";"Roustchouk";3;1884
399;127;"mars";1884;"directrice";"Roustchouk";1;1885
400;128;"avril";1873;"directeur";"Volo";3;1876
401;128;"janvier";1876;"directeur";"Widdin";1;1877
402;128;"juillet";1877;"directeur";"Andrinople";4;1881
403;128;"janvier";1881;"directeur";"Roustchouk";3;1884
404;128;"juin";1884;"professeur";"Ecole agricole";1;1885
405;129;"octobre";1895;"adjoint";"Jérusalem";2;1897
406;129;"octobre";1897;"adjoint";"Le Caire";3;1900
407;130;"octobre";1912;"adjointe";"Tétuan";9;1921
408;130;"octobre";1921;"adjointe";"Cple-haskeuy";17;1938
409;130;"octobre";1938;"adjointe";"Beyrouth";1;1939
410;131;"octobre";1931;"adjointe";"Fez";1;1932
411;131;"octobre";1932;"adjointe";"Bassora";7;1939
412;132;"février";1903;"adjointe";"Le Caire";3;1906
413;132;;1906;"directrice";"Damas";1;1907
414;132;"octobre";1907;"adjointe";"Le Caire";5;1912
415;133;"octobre";1890;"adjoint";"Fez";6;1896
416;133;;1896;"directeur";"Fez";6;1902
417;133;"octobre";1902;"directeur";"Rabat";4;1906
418;134;"octobre";1887;"adjoint";"Tunis";4;1891
419;134;"octobre";1891;"directeur";"Tatar-Bazardjik";2;1893
420;134;"octobre";1893;"adjoint";"Andrinople";8;1901
421;134;"octobre";1901;"directeur";"Ispahan";4;1905
422;134;"octobre";1905;"directeur";"Cple-Balata";7;1912
423;134;"mai";1912;"directeur";"Alger";;
424;135;"septembre";1892;"adjointe";"Tétuan";4;1896
425;136;"octobre";1911;"adjoint";"Sousse";1;1912
426;136;"octobre";1912;"adjoint";"Tunis";7;1919
427;137;"septembre";1907;"adjointe";"Janina";3;1910
428;137;"octobre";1910;"adjointe";"Tantah";1;1911
429;138;"décembre";1885;"adjointe";"Tunis";2;1887
430;138;"décembre";1887;"adjointe";"Philippopolis";1;1888
431;138;"octobre";1888;"directrice";"Dardanelles";1;1889
432;139;"octobre";1887;"adjointe";"Andrinople";3;1890
433;139;"septembre";1890;"adjointe";"Cple-Haskeuy";3;1893
434;139;"octobre";1893;"directrice intérimaire";"Cple-Galata";6;1899
435;139;"octobre";1899;"directrice";"Cple-Galata";2;1901
436;139;"octobre";1901;"directrice";"Cple-Conscoundjouk";4;1905
437;139;"octobre";1905;"directrice";"Cple-Conscoundjouk";9;1914
438;140;"octobre";1909;"adjointe";"Salonique";;
439;141;;1897;"adjoint";"Bagdad";3;1900
440;141;;1900;"adjoint";"Alexandrie";3;1903
441;142;"novembre";1880;"adjoint";"Cple-Balata";2;1882
442;142;"mars";1882;"directeur";"Choumla";3;1885
443;142;"octobre";1885;"directeur";"Varna";;
444;143;"octobre";1936;"adjoint";"Meknès";3;1939
445;144;;1899;"adjointe";"Cple-Haskeuy";1;1900
446;144;;1900;"adjointe";"Smyrne";1;1901
447;145;"octobre";1912;"adjointe";"Tantah";1;1913
448;145;"octobre";1913;"adjointe";"Alexandrie";7;1920
449;145;"octobre";1920;"adjointe";"Beyrouth";3;1923
450;146;"octobre";1906;"adjoint";"Janina";1;1907
451;146;"octobre";1907;"adjoint";"Andrinople";2;1909
452;146;"octobre";1909;"directeur";"Larache";1;1910
453;146;"octobre";1910;"directeur";"Marrakech";8;1918
454;147;"octobre";1930;"adjoint";"Bagdad";7;1937
455;147;"octobre";1937;"directeur";"Kirkouk";2;1939
456;148;"octobre";1912;"adjoint";"Tunis";7;1919
457;149;"octobre";1880;"adjoint";"Cple (école Camondo)";7;1887
458;150;"octobre";1933;"adjointe";"Casablanca";4;1937
459;150;"octobre";1937;"adjointe";"Bagdad";2;1939
460;151;"octobre";1914;"directeur";"Démotica";5;1919
461;152;"octobre";1914;"adjoint";"Monastir";2;1916
462;152;"octobre";1916;"adjoint";"Sefrou";11;1927
463;152;"octobre";1927;"adjoint";"Tanger";1;1928
464;152;"octobre";1928;"directeur";"Azemmour";1;1929
465;152;"octobre";1929;"directeur";"Fez";;
466;153;"octobre";1915;"adjointe";"?";8;1923
467;153;"octobre";1923;"adjointe";"Tanger";5;1928
468;153;"octobre";1928;"adjointe";"Azemmour";1;1929
469;153;"octobre";1929;"adjointe";"Fez";5;1934
470;153;"octobre";1934;"directrice";"Fez";;
471;154;"septembre";1892;"adjoint";"Tunis";4;1896
472;154;"octobre";1896;"adjoint";"Sousse";1;1897
473;155;"octobre";1889;"adjoint";"Salonique";15;1904
474;155;"octobre";1904;"directeur";"Serrès";2;1906
475;155;"octobre";1906;"adjoint";"Salonique";12;1918
476;156;"octobre";1933;"adjoint";"Tunis";;
477;157;"octobre";1934;"adjointe";"Fez";5;1939
478;158;;1899;"adjoint";"Damas";1;1900
479;158;;1900;"adjoint";"Le Caire";1;1901
480;159;"octobre";1896;"adjointe";"Cple-Haskeuy";3;1899
481;159;"octobre";1899;"adjointe";"Smyrne";1;1900
482;159;"octobre";1900;"directrice";"Caïffa";3;1903
483;160;"octobre";1905;"adjointe";"Le Caire";4;1909
484;161;"octobre";1927;"adjointe";"Beyrouth";1;1928
485;161;"octobre";1928;"adjointe";"Alep";2;1930
486;161;"octobre";1930;"adjointe";"Meknès";4;1934
487;161;"octobre";1934;"adjointe";"Safi";1;1935
488;161;"octobre";1935;"adjointe";"Mogador";4;1939
489;162;"octobre";1937;"adjoint";"Mogador";2;1939
490;163;"octobre";1906;"adjoint";"Sofia";4;1910
491;164;"octobre";1912;"adjointe";"Beyrouth";8;1920
492;165;"avril";1882;"directrice";"Tétuan";1;1883
493;165;"octobre";1883;"directrice";"Tatar-Bazardjik";1;1884
494;165;"octobre";1884;"directrice";"Beyrouth";7;1891
495;166;"octobre";1931;"adjoint";"Casablanca";2;1933
496;166;"octobre";1933;"adjoint";"Salé";3;1936
497;166;;1936;"adjoint";"Casablanca";2;1938
498;166;;1938;"adjoint";"Settat";1;1939
499;167;"octobre";1928;"adjoint";"Fez";1;1929
500;167;"octobre";1929;"adjoint";"Jérusalem";4;1933
501;167;"octobre";1933;"directeur";"Tibériade";1;1934
502;167;"octobre";1934;"adjoint";"Beyrouth";;
503;168;;1937;"adjointe";"Meknès";2;1939
504;169;;1895;"adjointe";"Tanger";2;1897
505;169;;1897;"adjointe";"Tétuan";5;1902
506;169;;1902;"adjointe";"Beyrouth";4;1906
507;169;;1906;"directrice";"Mazagan";3;1909
508;169;"mars";1909;"directrice";"Fez";6;1915
509;169;"octobre";1915;"directrice";"Rabat";9;1924
510;170;"octobre";1935;"adjointe";"Mogador";4;1939
511;171;"octobre";1905;"adjoint";"Sfax";1;1906
512;171;"octobre";1906;"adjoint";"Mogador";1;1907
513;171;"octobre";1907;"adjoint";"Mazagan";3;1910
514;171;"octobre";1910;"adjoint";"Mogador";1;1911
515;172;"octobre";1909;"adjointe";"Jaffa";2;1911
516;173;"octobre";1908;"adjointe";"Bagdad";1;1909
517;174;"octobre";1933;"adjointe";"Cple-Ortakeuy";3;1936
518;174;"octobre";1936;"mise à la disponibilité de";"Ecole du Caire";3;1939
519;175;"octobre";1913;"adjointe";"Sfax";3;1916
520;175;"octobre";1916;"adjointe";"Tunis";4;1920
521;176;"octobre";1906;"adjointe";"Cple-Galata";14;1920
522;177;;1897;"adjoint";"Smyrne";3;1900
523;177;;1900;"adjoint";"Sousse";1;1901
524;177;;1901;"adjoint";"Djédéïda";2;1903
525;178;;1897;"adjoint";"Tanger";5;1902
526;178;"mai";1902;"directeur";"Fez";0;1902
527;178;;1902;"adjoint";"Tétuan";2;1904
528;178;"octobre";1904;"directeur";"Marrakech";3;1907
529;178;"octobre";1907;"directeur";"Safi";1;1908
530;178;"octobre";1908;"directeur";"Marrakech";2;1910
531;178;"octobre";1910;"directeur";"Tétuan";5;1915
532;178;"octobre";1915;"directeur";"Mogador";5;1920
533;178;"octobre";1920;"au service du protectorat";;6;1926
534;178;;1926;"directeur";"Tanger";1;1927
535;178;"octobre";1927;"au service du protectorat";;;
536;179;;1899;"adjointe";"Tanger";3;1902
537;179;;1902;"directrice";"Fez";0;1902
538;179;;1902;"adjointe";"Tétuan";2;1904
539;179;;1904;"directrice";"Marrakech";3;1907
540;179;"octobre";1907;"directrice";"Safi";1;1908
541;179;"octobre";1908;"directrice";"Marrakech";2;1910
542;179;"octobre";1910;"directrice";"Tétuan";5;1915
543;179;"octobre";1915;"directrice";"Mogador";3;1918
544;180;"octobre";1910;"adjoint";"Bagdad";3;1913
545;180;"octobre";1913;"directeur";"Hillé";5;1918
546;181;;1902;"directrice";"Tibériade";1;1903
547;181;;1903;"directrice";"Caïffa";1;1904
548;182;"octobre";1903;"adjointe";"Alep";3;1906
549;182;"octobre";1906;"adjointe";"Cple-Conscoundjouk";1;1907
550;182;"mars";1907;"adjointe";"Alexandrie";0;1907
551;182;"octobre";1907;"adjointe";"Communauté (Alexandrie)";1;1908
552;182;"octobre";1908;"adjointe";"Cple-Haskeuy";12;1920
553;183;"septembre";1891;"adjoint";"Tunis";2;1893
554;183;"août";1893;"adjoint";"Le Plessis Picquet";2;1895
555;184;"octobre";1911;"adjointe";"Salonique";8;1919
556;185;"décembre";1904;"adjointe";"Bagdad";2;1906
557;185;"décembre";1906;"adjointe";"Hamadan";3;1909
558;186;"septembre";1892;"adjoint";"Beyrouth";2;1894
559;186;"octobre";1894;"adjoint";"Mikweh-Jérusalem";6;1900
560;186;"octobre";1900;"administrateur";"Jérusalem";1;1901
561;186;"octobre";1901;"adjoint";"Djédéïda";1;1902
562;186;"octobre";1902;"directeur";"Saïda";1;1903
563;186;"octobre";1903;"directeur";"Safed";10;1913
564;186;"octobre";1913;"directeur";"Alep";8;1921
565;186;"octobre";1921;"directeur";"Tantah";15;1936
566;187;"octobre";1913;"adjointe";"Tétuan";3;1916
567;187;"janvier";1916;"adjointe";"Tanger";5;1921
568;187;"octobre";1921;"adjointe";"Larache";1;1922
569;187;"octobre";1922;"adjointe";"Casablanca";;
570;188;"octobre";1937;"adjointe";"Sousse";2;1939
571;189;"octobre";1938;"adjointe";"Meknès";1;1939
572;190;"octobre";1911;"adjoint";"Tunis";1;1912
573;190;"octobre";1912;"adjoint";"Argentine";;
574;191;"décembre";1897;"adjointe";"Tunis";;
575;191;"novembre";1889;"adjointe";"Tanger";2;1891
576;191;"octobre";1891;"directrice";"Tatar-Bazardjik";3;1894
577;191;"octobre";1894;"adjointe";"Cple-Ortakeuy";2;1896
578;191;"mai";1896;"adjointe";"Andrinople";1;1897
579;191;"octobre";1897;"directrice";"Safed";3;1900
580;191;"octobre";1900;"directrice";"Choumla";5;1905
581;191;;1905;"directrice";"Gallipoli";2;1907
582;191;"octobre";1907;"adjointe";"Cple-Galata";2;1909
583;191;"mai";1909;"directrice";"Cple-Ortakeuy";10;1919
584;192;"décembre";1917;"adjointe";"Salé";6;1923
585;192;"décembre";1923;"adjointe";"Smyrne";3;1926
586;193;"octobre";1902;"adjointe";"Tripoli";2;1904
587;193;"octobre";1904;"adjointe";"Andrinople";2;1906
588;193;"octobre";1906;"adjointe";"Sofia";1;1907
589;193;"octobre";1907;"adjointe";"Cple-Haskeuy";1;1908
590;193;"octobre";1908;"adjointe";"Brousse";1;1909
591;193;"octobre";1909;"adjointe";"Damas";2;1911
592;193;"octobre";1911;"directrice";"Tibériade";3;1914
593;193;"octobre";1914;"adjointe";"Caïffa";7;1921
594;194;;1896;"directrice";"Tunis";4;1900
595;194;;1900;"directrice";"Salonique";18;1918
596;195;"octobre";1885;"adjointe";"Tunis";2;1887
597;195;"octobre";1887;"adjointe";"Cple-Haskeuy";14;1901
598;196;"octobre";1882;"adjoint";"Tunis";5;1887
599;196;"octobre";1887;"adjoint";"Cple-Haskeuy";14;1901
600;197;"octobre";1935;"adjointe";"Beyrouth";1;1936
601;198;"octobre";1927;"adjoint";"Marrakech";5;1932
602;198;"octobre";1932;"directeur";"Demnat";1;1933
603;198;"octobre";1933;"adjoint";"Rabat";1;1934
604;198;"octobre";1934;"adjoint";"Marrakech";;
605;199;"octobre";1911;"agronome";"Mikweh-Israël";1;1912
606;199;"octobre";1912;"agronome";"Djédéïda";17;1929
607;200;"octobre";1913;"adjoint";"Bagdad";2;1915
608;201;"octobre";1932;"adjoint";"Rabat";4;1936
609;201;"octobre";1936;"adjoint";"Beni-Mellal";3;1939
610;202;"octobre";1934;"adjointe";"Ispahan";2;1936
611;202;"octobre";1936;"adjointe";"Téhéran";3;1939
612;203;"octobre";1903;"adjointe";"Sofia";3;1906
613;203;"octobre";1906;"adjointe";"Damas";1;1907
614;203;"octobre";1907;"directrice";"Damas";3;1910
615;203;"octobre";1910;"directrice";"Roustchouk";2;1912
616;203;"janvier";1912;"directrice";"Aïdin";0;1912
617;203;"octobre";1912;"directrice";"Haïder Pacha";3;1915
618;203;"octobre";1915;"directrice";"Cple-Galata";;
619;204;"octobre";1935;"adjoint";"Meknès";4;1939
620;205;"octobre";1896;"adjointe";"Tétuan";1;1897
621;205;"octobre";1897;"directrice";"Brousse";1;1898
622;205;"octobre";1898;"directrice";"Caïffa";2;1900
623;205;"octobre";1900;"adjointe";"Cple-Balata";1;1901
624;205;"octobre";1901;"adjointe";"Cple-Galata";5;1906
625;206;"novembre";1906;"adjointe";"Marrakech";1;1907
626;206;"octobre";1907;"adjointe";"Tétuan";1;1908
627;206;"octobre";1908;"adjointe";"Larache";1;1909
628;207;"octobre";1933;"adjointe";"Meknès";2;1935
629;207;"octobre";1935;"adjointe";"Mazagan";1;1936
630;207;"octobre";1936;"adjointe";"Taroudout";3;1939
631;208;"octobre";1927;"adjointe";"Safi";2;1929
632;208;"octobre";1929;"adjointe";"Mogador";3;1932
633;208;"octobre";1932;"adjointe";"Ber-Rechid";1;1933
634;208;"octobre";1933;"adjointe";"Mogador";6;1939
635;209;"septembre";1892;"adjointe";"Cple-Haskeuy";1;1893
636;209;"octobre";1893;"adjointe";"Cple-Galata";26;1919
637;210;"septembre";1907;"adjoint";"Janina";1;1908
638;210;"octobre";1908;"adjoint";"Monastir";1;1909
639;210;"octobre";1909;"adjoint";"Jérusalem";1;1910
640;210;"octobre";1910;"adjoint";"Mikweh-Israël";2;1912
641;210;"octobre";1912;"directeur";"Gumuldjina";2;1914
642;210;"octobre";1914;"adjoint";"Andrinople";5;1919
643;211;"octobre";1916;"adjointe";"Tanger";3;1919
644;211;"octobre";1919;"adjointe";"Cple-Galata";8;1927
645;212;"octobre";1906;"adjointe";"Damas";3;1909
646;212;"octobre";1909;"adjointe";"Cple-Haskeuy";10;1919
647;212;"octobre";1919;"directrice";"Kapdar Pacha";8;1927
648;213;"février";1916;"adjointe";"Tétuan";3;1919
649;213;;1919;"adjointe";"Casablanca";3;1922
650;214;"octobre";1915;"adjointe";"Rabat";3;1918
651;215;"octobre";1916;"adjointe";"Tantah";4;1920
652;216;"octobre";1913;"adjoint";"Cple-Conscoundjouk";1;1914
653;217;"janvier";1904;"adjointe";"Le Caire";1;1905
654;217;"janvier";1905;"adjointe";"Tanger";3;1908
655;217;"octobre";1908;"directrice";"Larache";1;1909
656;217;"octobre";1909;"directrice";"Safi";5;1914
657;218;"octobre";1933;"adjoint";"Beni-Mellal";3;1936
658;218;"octobre";1936;"adjoint";"Casablanca";1;1937
659;219;"octobre";1910;"adjoint";"Salonique";1;1911
660;219;"octobre";1911;"adjoint";"Alep";1;1912
661;220;"octobre";1902;"adjoint";"Smyrne";1;1903
662;220;;1903;"adjoint";"Le Caire";1;1904
663;221;"mars";1867;"directeur";"Volo";2;1869
664;221;"juin";1869;"directeur";"Tanger";10;1879
665;221;"mars";1879;"directeur";"Jaffa (école agricole)";12;1891
666;222;;1881;"adjoint";"Cple-Hakeuy";2;1883
667;222;;1883;"directeur";"Cple-Haskeuy (école parti";1;1884
668;222;;1884;"directeur";"Brousse";3;1887
669;222;;1887;"adjoint";"Cple-Conscoundjouk";4;1891
670;222;;1891;"adjoint";"Cple-Haskeuy";;
671;223;"octobre";1933;"adjoint";"Safi";2;1935
672;223;"octobre";1935;"directeur";"Casablanca";2;1937
673;223;"octobre";1937;"adjoint";"Mazagan";2;1939
674;224;"octobre";1936;"adjointe";"Marrakech";3;1939
675;225;"octobre";1923;"adjointe";"Beyrouth";6;1929
676;225;"octobre";1929;"directrice";"Ispahan";4;1933
677;225;"octobre";1933;"directrice";"Hamadan";1;1934
678;225;"octobre";1934;"directrice";"Safi";;
679;226;"octobre";1910;"adjoint";"Tunis";1;1911
680;226;"octobre";1911;"directeur";"Bassorah";;
681;227;;1902;"professeur";"Roumanie";;
682;228;"septembre";1892;"adjoint";"Cple-Balata";1;1893
683;228;"septembre";1893;"adjoint";"Tunis";2;1895
684;229;"octobre";1934;"adjoint";"Sefrou";3;1937
685;229;"octobre";1937;"adjoint";"Tanger";2;1939
686;230;"octobre";1883;"adjointe";"Tunis";1;1884
687;231;;1902;"adjointe";"Téhéran";1;1903
688;231;;1903;"adjointe";"Damas";1;1904
689;231;;1904;"adjointe";"Smyrne";1;1905
690;231;;1905;"adjointe";"Salonique";2;1907
691;232;"octobre";1896;"adjointe";"Tunis";2;1898
692;232;"octobre";1898;"directrice";"Brousse";7;1905
693;232;"octobre";1905;"directrice";"Bagdad";9;1914
694;232;"février";1914;"directrice";"??";9;1923
695;232;"octobre";1923;"directrice";"Mazagan";5;1928
696;233;"octobre";1909;"adjointe";"Andrinople";2;1911
697;233;"octobre";1911;"directrice";"El-Ksar";8;1919
698;234;"octobre";1906;"adjoint";"Alexandrie";1;1907
699;235;"octobre";1902;"adjoint";"Tunis";1;1903
700;235;"octobre";1903;"adjoint";"Jérusalem (école professi";3;1906
701;235;"octobre";1906;"professseur";"Damas (Talmud-Torah)";2;1908
702;235;"octobre";1908;"directeur";"Tibériade";2;1910
703;235;"janvier";1910;"adjoint";"Jérusalem";1;1911
704;235;"octobre";1911;"directeur";"Jaffa";8;1919
705;235;"octobre";1919;"directeur";"Damas";6;1925
706;235;"octobre";1925;"directeur";"Jaffa";4;1929
707;235;"octobre";1929;"directeur";"Jérusalem (école professi";4;1933
708;235;"octobre";1933;"directeur";"Jérusalem (école professi";5;1938
709;236;"octobre";1932;"adjointe";"Meknès";4;1936
710;236;"octobre";1936;"adjointe";"Caïffa";1;1937
711;236;"octobre";1937;"adjointe";"Jérusalem";2;1939
712;237;"octobre";1916;"adjointe";"Téhéran";3;1919
713;238;"octobre";1928;"adjoint";"Safi";1;1929
714;239;;1900;"adjoint";"Tunis";2;1902
715;239;;1902;"adjoint";"Argentine";5;1907
716;239;"avril";1907;"adjoint";"Mogador";3;1910
717;239;"octobre";1910;"directeur";"Mazagan";1;1911
718;240;"novembre";1893;"maîtresse d'atelier";"Philippopolis";2;1895
719;240;"novembre";1895;"maîtresse d'atelier";"Sofia";7;1902
720;241;"octobre";1929;"adjointe";"Damas";3;1932
721;241;"octobre";1932;"adjointe";"Bagdad";5;1937
722;241;"octobre";1937;"directrice";"Kirkouk";2;1939
723;242;"octobre";1911;"adjointe";"Beyrouth";2;1913
724;242;"octobre";1913;"adjointe";"Alep";6;1919
725;243;;1901;"adjointe";"Tanger";1;1902
726;243;;1902;"adjointe";"Tétuan";2;1904
727;243;;1904;"directrice";"Casablanca";1;1905
728;243;;1905;"adjointe";"Tétuan";1;1906
729;243;;1906;"adjointe";"Cple-Ortakeuy";1;1907
730;243;;1907;"adjointe";"Cple-Balata";3;1910
731;244;"octobre";1909;"adjointe";"Sfax";4;1913
732;244;"octobre";1913;"adjointe";"Tripoli";5;1918
733;245;"juillet";1902;"adjoint";"Ispahan";4;1906
734;245;"octobre";1906;"directeur";"Chiraz";2;1908
735;245;"octobre";1908;"directeur";"Janina";3;1911
736;246;"octobre";1912;"adjoint";"Le Caire";3;1915
737;246;"octobre";1915;"adjoint";"Beyrouth";5;1920
738;246;"octobre";1920;"directeur";"Téhéran";9;1929
739;246;"octobre";1929;"directeur";"Jaffa";7;1936
740;246;"octobre";1936;"directeur";"Bagdad";3;1939
741;247;"octobre";1916;"adjoint";"Alexandrie (communauté)";2;1918
742;248;"octobre";1909;"adjoint";"Bagdad";3;1912
743;248;"janvier";1912;"adjoint";"Téhéran";0;1912
744;248;"octobre";1912;"adjoint";"Ispahan";;
745;248;;;"démissionnaire";;;
746;248;"octobre";1929;"adjoint";"Téhéran";1;1930
747;249;"septembre";1907;"adjoint";"Chiraz";3;1910
748;249;"janvier";1910;"adjoint";"Tanger";1;1911
749;249;"décembre";1911;"professeur";"Argentine";3;1914
750;250;"octobre";1919;"adjointe";"Rhodes";1;1920
751;251;"octobre";1915;"adjoint";"?";4;1919
752;251;"octobre";1919;"adjoint";"Rabat";2;1921
753;251;"octobre";1921;"directeur";"Larache";8;1929
754;251;"octobre";1929;"directeur";"Meknès";;
755;252;"octobre";1917;"adjointe";"Tanger";9;1926
756;252;"janvier";1926;"adjointe";"Larache";3;1929
757;252;"octobre";1929;"directrice";"Meknès";;
758;253;"octobre";1935;"adjointe";"Caïffa";1;1936
759;254;"septembre";1907;"adjoint";"Damas";2;1909
760;254;"octobre";1909;"adjoint";"Argentine";9;1918
761;254;"octobre";1918;"directeur";"Safi";2;1920
762;254;"octobre";1920;"directeur";"Rhodes";2;1922
763;255;"octobre";1908;"adjointe";"Tunis";3;1911
764;255;"octobre";1911;"adjointe";"Cple-Ortakeuy";2;1913
765;256;"octobre";1879;"directeur";"Philippopolis";4;1883
766;256;"octobre";1883;"directeur";"Andrinople";20;1903
767;256;"octobre";1903;"directeur";"Mikweh-Israël";11;1914
768;256;"janvier";1914;"directeur";"Jérusalem";15;1929
769;257;"octobre";1931;"adjointe";"Safi";4;1935
770;257;"octobre";1935;"adjointe";"Marrakech";4;1939
771;257;"octobre";1939;"adjointe";"El-Ksar";1;1940
772;258;;1898;"adjointe";"Alexandrie";1;1899
773;258;;1899;"adjointe";"Sofia";1;1900
774;258;;1900;"directrice";"Roustchouk";5;1905
775;258;;1905;"directrice";"Choumla";5;1910
776;259;"octobre";1932;"adjointe";"Fez";3;1935
777;259;"octobre";1935;"adjointe";"Mazagan";4;1939
778;260;"décembre";1922;"adjointe";"Bagdad";2;1924
779;260;"octobre";1924;"directrice";"Hamadan";1;1925
780;260;"octobre";1925;"directrice";"Kimandah";4;1929
781;261;"octobre";1922;"adjoint";"Bagdad";2;1924
782;261;"octobre";1924;"directeur";"Hamadan";1;1925
783;261;"octobre";1925;"directeur";"Kimandah";4;1929
784;262;"octobre";1934;"adjoint";"Mazagan";1;1935
785;262;"octobre";1935;"adjoint";"Fez";2;1937
786;263;"décembre";1892;"adjointe";"Andrinople";3;1895
787;263;"octobre";1895;"adjointe";"Cple-Haskeuy";2;1897
788;264;"octobre";1903;"adjointe";"Hamadan";1;1904
789;264;"septembre";1904;"adjointe";"Cple-Balata";3;1907
790;264;"octobre";1907;"adjointe";"Smyrne";5;1912
791;264;"octobre";1912;"adjointe";"Alexandrie";3;1915
792;264;"octobre";1915;"adjointe";"Le Caire (communauté)";12;1927
793;265;"octobre";1876;"directeur";"Tétuan";4;1880
794;265;"novembre";1880;"directeur";"Tanger";5;1885
795;265;"novembre";1885;"directeur";"Brousse";9;1894
796;265;"avril";1894;"directeur";"Salonique";10;1904
797;265;"octobre";1904;"inspecteur d'écoles";"Macédoine";1;1905
798;266;"octobre";1925;"adjoint";"Fez";2;1927
799;266;"octobre";1927;"adjoint";"Smyrne";3;1930
800;266;"octobre";1930;"adjoint";"Bagdad";5;1935
801;266;"octobre";1935;"directeur";"Bassorah";4;1939
802;267;"octobre";1905;"adjointe";"Le Caire";3;1908
803;268;"octobre";1922;"adjoint";"Bagdad";5;1927
804;268;"janvier";1927;"directeur";"Bassorah";8;1935
805;268;"octobre";1935;"directeur";"Alep";4;1939
806;269;"octobre";1928;"adjointe";"Tanger";;
807;270;"octobre";1903;"adjoint";"Tunis";1;1904
808;270;"octobre";1904;"professeur";"Palestine";;
809;271;;1901;"adjoint";"Salonique";13;1914
810;271;"octobre";1914;"directeur";"Salonique";7;1921
811;272;"octobre";1913;"adjoint";"Rabat";1;1914
812;273;"février";1887;"adjointe";"Tétuan";2;1889
813;273;"octobre";1889;"adjointe";"Andrinople";2;1891
814;274;"janvier";1915;"directeur";"Sefrou";1;1916
815;274;"octobre";1916;"adjoint";"Tanger";2;1918
816;275;"octobre";1930;"adjointe";"Marrakech";4;1934
817;275;"octobre";1934;"adjointe";"Demnat";3;1937
818;275;"octobre";1937;"adjointe";"Casablanca";2;1939
819;276;"octobre";1913;"adjoint";"Safi";1;1914
820;277;"octobre";1910;"adjointe";"Casablanca";1;1911
821;278;"octobre";1879;"adjoint";"Tunis";4;1883
822;278;"janvier";1883;"directeur";"Sousse";4;1887
823;278;"mars";1887;"adjoint";"Cple-Haskeuy";1;1888
824;278;"janvier";1888;"adjoint";"Cple-Galata";9;1897
825;278;"janvier";1897;"directeur";"Cple-Haskeuy";9;1906
826;278;"octobre";1906;"directeur";"Smyrne";15;1921
827;279;"octobre";1923;"adjointe";"Smyrne";2;1925
828;279;"octobre";1925;"adjointe";"Salé";10;1935
829;279;"octobre";1935;"adjointe";"Rabat";4;1939
830;280;"octobre";1911;"adjointe";"Tunis";10;1921
831;280;"octobre";1921;"adjointe";"Casablanca";11;1932
832;281;"octobre";1931;"adjointe";"Mazagan";4;1935
833;281;"octobre";1935;"directrice";"Ber Rechid";4;1939
834;282;"octobre";1936;"adjoint";"Safi";1;1937
835;282;"octobre";1937;"directeur";"Oued-Zem";2;1939
836;283;"octobre";1936;"adjoint";"Marrakech";3;1939
837;284;"septembre";1891;"adjoint";"Tunis";2;1893
838;285;"octobre";1914;"adjointe";"Rabat";2;1916
839;285;"octobre";1916;"adjointe";"Salé";2;1918
840;286;"octobre";1932;"adjointe";"Casablanca";;
841;287;"octobre";1935;"adjointe";"Mogador";4;1939
842;288;"octobre";1912;"adjointe";"Tripoli";3;1915
843;289;"octobre";1911;"adjointe";"Bagdad";2;1913
844;289;"octobre";1913;"directrice";"Seneh";11;1924
845;290;"octobre";1915;"adjointe";"Safi";2;1917
846;290;"avril";1917;"adjointe";"Mogador";1;1918
847;291;"mars";1870;"directeur";"Choumla";3;1873
848;291;"juin";1873;"directeur";"Roustchouk";4;1877
849;291;"juillet";1877;"directeur intérimaire";"Jaffa";1;1878
850;291;"janvier";1878;"directeur";"Smyrne";15;1893
851;291;"décembre";1883;"directeur";"Tunis";7;1890
852;292;"septembre";1907;"adjoint";"Cple-Balata";3;1910
853;293;"novembre";1875;"adjoint";"Salonique";11;1886
854;294;"octobre";1911;"adjoint";"Jérusalem";2;1913
855;294;"octobre";1913;"directeur";"Saïda";2;1915
856;294;"octobre";1915;"directeur intérimaire";"Beyrouth";6;1921
857;294;"octobre";1921;"directeur";"Alep";11;1932
858;294;"octobre";1932;"directeur";"Beyrouth";;
859;295;"octobre";1929;"adjoint";"Ben-Ahmed";4;1933
860;295;"octobre";1933;"adjoint";"Casablanca";;
861;296;"octobre";1916;"adjoint";"Safi";2;1918
862;297;"novembre";1879;"directeur";"Alcazar";3;1882
863;297;"février";1882;"adjoint";"Tanger";1;1883
864;298;"octobre";1930;"adjoint";"Meknès";1;1931
865;298;"octobre";1931;"adjoint";"Casablanca";6;1937
866;298;"octobre";1937;"adjoint";"Safi";2;1939
867;299;"octobre";1910;"adjointe";"Bagdad";3;1913
868;299;"octobre";1913;"adjointe";"Andrinople";6;1919
869;299;;1919;"adjointe";"Brousse";2;1921
870;299;;1921;"adjointe";"Smyrne";4;1925
871;300;"décembre";1918;"adjointe";"Meknès";3;1921
872;300;"octobre";1921;"adjointe";"Fez";6;1927
873;300;"octobre";1927;"adjointe";"Safi";8;1935
874;300;"octobre";1935;"adjointe";"Meknès";2;1937
875;301;"octobre";1912;"adjointe";"Jérusalem";1;1913
876;301;"octobre";1913;"adjointe";"Bagdad";9;1922
877;301;"octobre";1922;"adjointe";"Beyrouth";3;1925
878;301;"octobre";1925;"directrice";"Hamadan";8;1933
879;301;"octobre";1933;"directrice";"Ispahan";3;1936
880;301;"octobre";1936;"directrice";"Téhéran";3;1939
881;302;"octobre";1935;"adjointe";"Rabat";1;1936
882;302;"octobre";1936;"adjointe";"Marrakech";3;1939
883;303;"octobre";1931;"adjoint";"Salé";2;1933
884;303;"octobre";1933;"adjoint";"Mogador";2;1935
885;303;"octobre";1935;"adjoint";"Mazagan";4;1939
886;304;"octobre";1912;"adjoint";"Tunis";1;1913
887;304;"octobre";1913;"adjoint";"Djédéïda";1;1914
888;304;"octobre";1914;"adjoint";"Tunis";2;1916
889;305;"octobre";1926;"adjoint";"Jaffa";1;1927
890;306;"janvier";1887;"adjointe";"Andrinople";2;1889
891;306;"octobre";1889;"directrice";"Alep";5;1894
892;306;"octobre";1894;"adjointe";"Beyrouth";8;1902
893;306;"octobre";1902;"directrice";"Safed";1;1903
894;306;"octobre";1903;"directrice";"Tibériade";8;1911
895;307;"octobre";1934;"adjoint";"Hamadan";2;1936
896;308;"octobre";1909;"adjointe";"Cple-Balata";1;1910
897;308;"octobre";1910;"adjointe";"Smyrne";9;1919
898;309;"octobre";1903;"adjoint";"Mogador";2;1905
899;309;"octobre";1905;"adjoint";"Monastir";1;1906
900;309;"octobre";1906;"adjoint";"Andrinople";4;1910
901;309;"octobre";1910;"adjoint";"Larache";1;1911
902;309;"octobre";1911;"directeur";"Damas";1;1912
903;309;"octobre";1912;"directeur";"Caïffa";8;1920
904;310;"octobre";1936;"adjointe";"Fez";3;1939
905;311;"octobre";1905;"adjointe";"Tunis";2;1907
906;311;"janvier";1907;"adjointe";"Beyrouth";3;1910
907;312;"octobre";1910;"adjointe";"Mogador";3;1913
908;312;"janvier";1913;"directrice";"Rabat";1;1914
909;312;"octobre";1914;"adjointe";"Andrinople";8;1922
910;313;"octobre";1935;"adjointe";"Sfax";3;1938
911;313;"octobre";1938;"adjointe";"Tunis";1;1939
912;314;"octobre";1902;"adjoint";"Tunis";4;1906
913;314;"décembre";1906;"adjoint";"Sousse";1;1907
914;314;"octobre";1907;"directeur";"Mossoul";5;1912
915;314;"octobre";1912;"directeur";"Beyrouth";3;1915
916;314;"octobre";1915;"adjoint";"Alexandrie";3;1918
917;314;"octobre";1918;"directeur";"Jérusalem";5;1923
918;314;"octobre";1923;"directeur";"Beyrouth";12;1935
919;314;"octobre";1935;"directeur";"Auteuil";4;1939
920;315;"octobre";1931;"adjoint";"Safi";3;1934
921;315;"avril";1934;"adjoint";"Meknès";0;1934
922;315;"octobre";1934;"adjoint";"Tiznit";1;1935
923;315;"octobre";1935;"adjoint";"Marrakech";4;1939
924;316;"septembre";1891;"adjointe";"Tunis";5;1896
925;316;"octobre";1896;"directrice";"Magnésie";3;1899
926;316;"octobre";1899;"directrice";"Damas";7;1906
927;316;"octobre";1906;"directrice";"Cple-Haskeuy";16;1922
928;317;"octobre";1928;"adjointe";"Settat";2;1930
929;317;"octobre";1930;"adjointe";"Larache";5;1935
930;317;"octobre";1935;"adjointe";"Mogador";2;1937
931;317;"octobre";1937;"adjointe";"Casablanca";2;1939
932;318;"octobre";1932;"adjointe";"Marrakech";1;1933
933;318;"octobre";1933;"adjointe";"Tibériade";1;1934
934;319;"octobre";1919;"adjointe";"Salonique";10;1929
935;319;"janvier";1929;"directrice";"Salonique";8;1937
936;320;"octobre";1925;"adjoint";"Mogador";1;1926
937;320;"octobre";1926;"adjoint";"Tunis";12;1938
938;320;"octobre";1938;"directeur";"Sousse";1;1939
939;321;"octobre";1914;"adjoint";"Meknès";5;1919
940;321;"octobre";1919;"directeur";"Salé";7;1926
941;321;"octobre";1926;"directeur";"Casablanca";;
942;322;"octobre";1908;"adjoint";"Tunis";5;1913
943;322;"octobre";1913;"directeur";"Salé";1;1914
944;322;"octobre";1914;"adjoint";"Tunis";;
945;323;"octobre";1884;"adjoint";"Tunis";9;1893
946;323;"avril";1893;"directeur";"Sousse";9;1902
947;323;"novembre";1902;"directeur";"Mogador";7;1909
948;323;"avril";1909;"directeur";"Oran";1;1910
949;323;"octobre";1910;"directeur";"Tanger";2;1912
950;323;"octobre";1912;"directeur";"Oran";2;1914
951;324;"octobre";1928;"adjointe";"Alep";6;1934
952;324;"octobre";1934;"adjointe";"Beyrouth";;
953;325;"octobre";1911;"adjointe";"Bagdad";9;1920
954;325;"octobre";1920;"adjointe";"Cple-Conscoundjouj";3;1923
955;325;"octobre";1923;"adjointe";"Andrinople";1;1924
956;325;"octobre";1924;"adjointe";"Cple-Haskeuy";4;1928
957;325;"octobre";1928;"adjointe";"Smyrne";3;1931
958;325;"octobre";1931;"adjointe";"Cple-Ortakeuy";2;1933
959;325;"octobre";1933;"adjointe";"Casablanca";;
960;326;"octobre";1938;"adjointe";"Sfax";1;1939
961;327;"octobre";1908;"adjoint";"Tunis";4;1912
962;327;"janvier";1912;"directeur";"Sefrou";1;1913
963;327;"janvier";1913;"adjoint";"Fez";1;1914
964;328;"octobre";1930;"adjointe";"Alep";2;1932
965;329;"octobre";1914;"adjointe";"Casablanca";7;1921
966;329;"octobre";1921;"adjointe";"Tanger";6;1927
967;329;"octobre";1927;"adjointe";"Mazagan";1;1928
968;329;"octobre";1928;"adjointe";"Casablanca";4;1932
969;329;"octobre";1932;"directrice";"Marrakech";7;1939
970;330;"octobre";1936;"adjointe";"Jérusalem";3;1939
971;331;"février";1882;"directrice";"Tunis";6;1888
972;331;"novembre";1888;"directrice";"Sofia";2;1890
973;331;"octobre";1890;"directrice";"Andrinople";19;1909
974;332;"novembre";1902;"adjointe";"Hamadan";1;1903
975;332;"novembre";1903;"directrice";"Chiraz";;
976;333;"octobre";1888;"adjointe";"Cple-Balata";1;1889
977;333;"octobre";1889;"adjointe";"Smyrne";7;1896
978;333;"octobre";1896;"chargée de direction";"Brousse";1;1897
979;333;"octobre";1897;"adjointe";"Smyrne";4;1901
980;333;"octobre";1901;"adjointe";"Alexandrie";1;1902
981;333;"octobre";1902;"directrice";"Dardanelles";13;1915
982;333;;1915;"adjointe";"Cple-Galata";14;1929
983;334;"octobre";1913;"adjointe";"Cple-Uskub";4;1917
984;334;;1917;"adjointe";"Cple-Galata";6;1923
985;335;"mai";1876;"directrice";"Choumla";4;1880
986;335;"janvier";1880;"directrice";"Cple-Galata";14;1894
987;335;"octobre";1894;"directrice";"Cple-Conscoundjouk";4;1898
988;335;"octobre";1898;"directrice";"Cple-Ortakeuy";9;1907
989;336;"octobre";1894;"directrice";"Alep";6;1900
990;336;;1900;"directrice";"Tatar-Bazardjik";4;1904
991;336;;1904;"directrice";"Roustchouk";8;1912
992;337;"octobre";1928;"adjointe";"Tanger";;
993;338;"octobre";1914;"adjointe";"Cavalla";3;1917
994;338;"octobre";1917;"adjointe";"Salonique";2;1919
995;339;"octobre";1910;"adjoint";"Mazagan";3;1913
996;340;"octobre";1911;"adjoint";"Cple-Czendjik";1;1912
997;340;"octobre";1912;"directeur";"Démotica";10;1922
998;340;"octobre";1922;"adjoint";"Brousse";1;1923
999;340;;1923;"directeur";"Smyrne (Talmud-Tora)";11;1934
1000;340;"octobre";1934;"adjoint";"Tanger";;
